Fusicoccin	Methionine aminopeptidase	1
Isopropyl beta-D-thiogalactopyranoside	Extended-spectrum beta-lactamase PER-1	1
Iodobenzene	L-fucose isomerase	1
Grepafloxacin	Matrix metalloproteinase-19	1
Flavin adenine dinucleotide	Macrophage metalloelastase	1
Boceprevir	Flavodoxin	1
Erteberel	Keratin, type I cytoskeletal 12	1
Ursodeoxycholic acid	ATP-sensitive inward rectifier potassium channel 8	1
Epoprostenol	Fatty acid-binding protein TM_1468	1
Levomilnacipran	Tubulin beta-3 chain	1
Penicillin G Acyl-Serine	Mast/stem cell growth factor receptor Kit	1
Eflornithine	Bone morphogenetic protein receptor type-1B	1
Etelcalcetide	Nuclear factor NF-kappa-B p100 subunit	1
Valaciclovir	L-asparaginase	1
Monofluorophosphate ion	Acetyl-CoA acetyltransferase	1
Dexrazoxane	Large ribosomal subunit protein uL29	1
Lomerizine	UDP-N-acetylenolpyruvoylglucosamine reductase	1
Alendronic acid	1-deoxy-D-xylulose 5-phosphate reductoisomerase	1
Phenyltoloxamine	Response regulator PleD	1
Edoxudine	Cytochrome c-552	1
Alvimopan	Peptide deformylase	1
Quinine	Microtubule-associated protein 2	1
Bretylium	Galectin-2	1
Pyruvic acid	Sterol O-acyltransferase 2	1
Arginine	Ribose-5-phosphate isomerase A	1
(R,R)-2,3-Butanediol	Ferripyoverdine receptor	1
Roxithromycin	SEC14-like protein 4	1
2s,4r-4-Methylglutamate	Corrinoid adenosyltransferase MMAB	1
Phosphomethylphosphonic acid guanosyl ester	Alkaline phosphatase, tissue-nonspecific isozyme	1
Vidarabine	Probable pyruvate-flavodoxin oxidoreductase	1
Tanespimycin	Ferredoxin--NADP reductase	1
S-(2,4-dinitrophenyl)glutathione	Phosphopantetheine adenylyltransferase	1
Arformoterol	Vitamin K-dependent protein C	1
Vortioxetine	DNA beta-glucosyltransferase	1
Isoprenaline	Cryptochrome DASH	1
Cefadroxil	Serine/threonine-protein kinase PAK 3	1
Carglumic acid	Caspase-1	1
Clopidogrel	ATP phosphoribosyltransferase	1
Olsalazine	Cathepsin G	1
Sarpogrelate	Iron-dependent extradiol dioxygenase	1
Dihydrofolic Acid	Glutathione S-transferase A4	1
3,5-Dinitrocatechol	Glutamate dehydrogenase 2, mitochondrial	1
AICA ribonucleotide	Tubulin beta chain	1
N-Valeric Acid	Aspartate ammonia-lyase	1
Tetrahydrodeoxyuridine	Oxytocin receptor	1
(2s)-Pyrrolidin-2-Ylmethylamine	tRNA	1
Remifentanil	NADPH-flavin oxidoreductase	1
D-naphthyl-1-acetamido boronic acid alanine	Motilin receptor	1
Gemifloxacin	GDP-mannose 6-dehydrogenase	1
Niflumic acid	Uridine phosphorylase 1	1
5-Aminoimidazole Ribonucleoside	Succinate dehydrogenase [ubiquinone] flavoprotein subunit, mitochondrial	1
Reidispongiolide A	Calcitonin receptor	1
trans-2-hydroxycinnamic acid	Aminoglycoside N	1
Fluticasone furoate	Glutamate receptor ionotropic, kainate 4	1
Baricitinib	Arabinose operon regulatory protein	1
OLOMOUCINE II	Indole-3-pyruvate decarboxylase	1
Avasimibe	Mitogen-activated protein kinase kinase kinase kinase 1	1
2-Cyclopropylmethylenepropanal	Uridine-cytidine kinase 2	1
6-(Oxalyl-Amino)-1h-Indole-5-Carboxylic Acid	Arsenical pump-driving ATPase	1
2'-HYDROXY-1,1'-BIPHENYL-2-SULFINIC ACID	Benzoylformate decarboxylase	1
1-[5-Methyl-2-(trifluoromethyl)furan-3-yl]-3-[5-[2-[[6-(1H-1,2,4-triazol-5-ylamino)pyrimidin-4-yl]amino]ethyl]-1,3-thiazol-2-yl]urea	Beta-lactamase	1
4-{2-[(7-amino-2-furan-2-yl[1,2,4]triazolo[1,5-a][1,3,5]triazin-5-yl)amino]ethyl}phenol	Diacylglycerol kinase delta	1
S-Adenosyl-L-Homoselenocysteine	Reaction center protein L chain	1
5,6-Dimethylbenzimidazole	Interleukin-1 receptor-associated kinase 1	1
Sinefungin	Group IIE secretory phospholipase A2	1
2-Decenoyl N-Acetyl Cysteamine	Reaction center protein H chain	1
2-O-Methyl-beta-L-fucopyranose	Octanoyltransferase	1
S-benzylglutathione	ATP-dependent DNA helicase RecQ	1
Medrysone	Isocitrate lyase	1
Nonivamide	Muscarinic acetylcholine receptor M3	1
5-[(4-AMINOCYCLOHEXYL)AMINO]-7-(PROPAN-2-YLAMINO)PYRAZOLO[1,5-A]PYRIMIDINE-3-CARBONITRILE	Annexin A4	1
Cefiderocol	Sodium-dependent proline transporter	1
2',3'-Dideoxyadenosine triphosphate	Tyrosine-protein kinase TXK	1
Alpha-D-Galactose-1-Phosphate	N-acetylglucosamine-6-phosphate deacetylase	1
Formycin	L-lactate dehydrogenase C chain	1
Lamivudine	Trafficking protein particle complex subunit 6B	1
RPR131247	Geranylgeranyl transferase type-2 subunit alpha	1
L-Leucyl-Hydroxylamine	Uncharacterized serine/threonine-protein kinase SBK3	1
Etafedrine	1-phosphatidylinositol 4,5-bisphosphate phosphodiesterase delta-1	1
2-Iminiopropanoate	Mitogen-activated protein kinase 10	1
Trans-O-Hydroxy-Alpha-Methyl Cinnamate	Synaptic vesicle glycoprotein 2A	1
1-Naphthyl-L-alanine	CAI-1 autoinducer synthase	1
tert-butyl 4-(3-thiophen-2-yl-1,2,4-oxadiazol-5-yl)piperidine-1-carboxylate	5-hydroxytryptamine receptor 1D	1
Brigatinib	E3 ubiquitin-protein ligase TRIM13	1
6-Amino-4-Hydroxymethyl-Cyclohex-4-Ene-1,2,3-Triol	Myosin light chain 6B	1
Astaxanthin	Solute carrier family 13 member 1	1
Carfilzomib	72 kDa type IV collagenase	1
Quizartinib	Nitric oxide synthase oxygenase	1
4-Methyl-N-[5-(5-methyl-furan-2-ylmethylene)-4-oxo-thiazolidin-2-ylidene]-benzenesulfonamide	3-phosphoshikimate 1-carboxyvinyltransferase	1
(S)-2-((S)-3-isobutyl-2,5-dioxo-4-quinolin-3-ylmethyl-[1,4]diazepan-1yl)-N-methyl-3-naphtalen-2-yl-propionamide	Cystathionine beta-synthase	1
Betamethasone	Response regulator PleD	1
4-NITROPHENYL-(6-S-ALPHA-D-XYLOPYRANOSYL)-BETA-D-GLUCOPYRANOSIDE	Macrophage metalloelastase	1
3-AMINO-AZACYCLOTRIDECAN-2-ONE	Elongation factor 1-alpha 1	1
Butobarbital	Folate receptor alpha	1
Thymectacin	Transforming protein RhoA	1
Propidium	Ribosomal small subunit pseudouridine synthase A	1
(3r)-1-Acetyl-3-Methylpiperidine	ADP/ATP translocase 2	1
Tolterodine	Organic cation/carnitine transporter 2	1
Miconazole	Reaction center protein H chain	1
Aclidinium	Methionine aminopeptidase 2	1